|||||||||||||||||||||||||||||||||||||||||||||/
|...........................................|/
|...........................................|/
|...........................................|/
|...........................................|/
|...........................................|/
|...........................................|/
|...........................................|/
|...........................................|/
|...........................................|/
|...........................................|/
|...........................................|/
|...........................................|/
|...........................................|/
|...........................................|/
|...........................................|/
|...........................................|/
|...........................................|/
|...........................................|/
|...........................................|/
|...........................................|/
|...........................................|/
|...........................................|/
|...........................................|/
|...........................................|/
|...........................................|/
|...........................................|/
|.....................+.....................|/
|...........................................|/
|||||||||||||||||||||||||||||||||||||||||||||/
//////////////////////////////////////////////